0 0 0 0 0 0 0 0 0 0 0 0 0 0 0]
                             ]
0 0 0 0 0 0 0 0 0 0 0 0 0 0 0]
                             ]
0 0 0 0 0 0 0 0 0 0 0 0 0 0 0]
                             ]
0 0 0 0 0 0 0 0 0 0 0 0 0 0 0]
                             ]
0 0 0 1-1-1-6 3-1 7 1-1 0 0 0]
      |                      ]
0 0 0 1 0 0 0 0 0 0 0 7 0 0 0]
                             ]
0 0 1 7 1 0 0 0 0 0 0 1 0 0 0]
    |   |             |      ]
0 0 1 0 1 0 0 0 0 0 0 1 0 0 0]
    |   |             |      ]
0 0 4 0 4 0 0 0 0 0 0 1 0 0 0]
    |   |             |      ]
0 0 1-1-1 0 0 0 0 0 0 1 0 0 0]
      |               |      ]
0 0 0 1 0 0 0 0 0 0 0 1 0 0 0]
      |               |      ]
0 0 0 1-1-1-1-4-1-1-1-1 0 0 0]
                             ]
0 0 0 0 0 0 0 0 0 0 0 0 0 0 0]
                             ]
0 0 0 0 0 0 0 0 0 0 0 0 0 0 0]
                             ]
0 0 0 0 0 0 0 0 0 0 0 0 0 0 0]
