0 0 0 0 7 0 0 4 0 0 0 0 0 0 0]
                |            ]
0 1 0-1 0 1-0 0 1 0 1 0 0 0 0]
                    |        ]
0 0 0 0 0 0 0 0 0 0 0 0 0 0 0]
      |                      ]
0 0 0-3 0 0-3-0 0-3 0 0 0 0 0]
                  |          ]
0 0 0 0 0 0 0 0 0 0 0 0 0 0 0]
    |     |         |        ]
7 0 6-0 0 6 0 6-0 0-6-0 0 0 0]
          |   |              ]
0 0 0 0 0 0 0 0 0 0 0 0 0 0 7]
    |   |           |        ]
0 0-1 0 1-0 0-1-0 0-1-0 0 0 0]
    |   |     |     |        ]
0 0 0 0 0 0 0 0 7 0 0 0 0 0 0]
                             ]
0 7 3 0 3 7 0 0 3 0 3 0 0 0 0]
                             ]
0 0 7 0 0 0 0 0 0 0 7 7 0 0 0]
                             ]
0 7 6 0 7 6 7 0 7 6 0 6 7 0 0]
                             ]
0 7 0 0 0 0 7 0 0 7 0 0 7 0 0]
                             ]
0 1 0 1 7 7 1 7 0 7 1 7 1 7 0]
                             ]
0 7 0 7 0 0 0 0 0 0 7 0 7 0 0]
