0 0 0 0 0 0 0 0 0 0 0 0 0 0 0]
                             ]
0 0 0 0 0 4-1 7 1-9-1 0 0 0 0]
          |         |        ]
0 1-1-1-1-1 0 1-1-1-1-1 0 0 0]
  |       |       |   |      ]
0 4 0 0 0 1-1 7 0 4 0 9 0 0 0]
  |               |   |      ]
0 1-1 7 5-1-1-1 7 1 7 1 0 0 0]
        *                    ]
0 0 0 0 0 0 0 0 0 0 0 0 0 0 0]
                             ]
0 0 0 0 0 0 0 0 0 0 0 0 0 0 0]
                             ]
0 0 0 0 8 0 8 0 0 0 0 0 0 0 0]
                             ]
0 0 0 0 0 0 0 0 0 0 0 0 0 0 0]
                             ]
0 0 0 8 0 0 8 0 0 0 0 0 0 0 0]
                             ]
0 0 0 0 0 0 0 0 7 7 1-1-4 0 0]
      *                 |    ]
0 0 1-2-1-1-1-1-1-9 0 0 1 0 0]
                        |    ]
0 0 7 1-9-1 7 0 7 1-1-9-1 0 0]
                        |    ]
0 0 7 1-6 3-1 7 1-1-1-1-4 0 0]
                             ]
0 0 0 0 0 0 0 0 0 0 0 0 0 0 0]