0 0 0 0 0 0 0 0 0 0 0 0 0 0 0]
                             ]
0 0 1-1-1 0 0 0 0 0 0 0 0 0 0]
    |   |                    ]
0 0 4 0 5+0 0 8 0 0 0 0 0 0 8]
    |   |                    ]
0 0 1-1-1 0 0 0 0 0 0 0 0 0 0]
                             ]
0 0 0 0 0 0 0 0 0 0 0 0 0 0 8]
              *              ]
0 0 0 0 0 1-1-2-1-1 0 0 0 0 0]
          |       |          ]
0 0 0 0 0 1 0 0 0 1 0 0 0 0 0]
          |       |          ]
0 0 0 0 0 1-6 3-1-1 0 0 0 0 0]
          |       |          ]
0 0 0 0 0+2 0 0 0 2+0 0 0 0 0]
          |       |          ]
0 0 0 0 0 1-1-2-1-1 0 0 0 0 0]
              *              ]
0 0 0 0 0 0 0 0 0 0 0 0 0 0 0]
                             ]
0 0 0 0 0 0 0 0 0 0 0 0 0 0 0]
                             ]
0 0 0 0 0 0 0 8 0 0 0 0 0 0 0]
                             ]
0 0 0 0 0 0 0 0 0 0 0 0 0 0 0]
                             ]
0 0 0 0 0 0 0 0 0 0 0 0 0 0 0]