0 0 0 0 0 0 0 0 0 0 0 0 0 0 0]
                             ]
0 0 0 0 0 0 0 0 0 0 1-1 0 0 0]
                    | |      ]
0 0 8 0 0 0 0 0 8 0+5 4 0 0 0]
                    | |      ]
0 0 0 0 0 0 0 0 0 0 1-1 0 0 0]
    *                        ]
0 1-5-1-1 0 0 0 0 0 0 0 0 0 0]
        |                    ]
0 7 1-9-1 0 8 0 8 0 0 8 0 0 0]
        |                    ]
0 1-2-4-1 0 0 0 0 0 0 0 0 0 0]
    *       *                ]
0 0 0 0 1-1-2-1 0 8 0 8 0 0 0]
        |     |              ]
0 0 0 0 1-6 3-1 0 0 0 0 0 0 0]
                             ]
0 0 0 0 0 0 0 0 0 0 0 0 0 0 0]
    *               *        ]
0 1-5-1 0 0 0 0 1-1-5-1 0 0 0]
      |         |     |      ]
0 7 9-1 0 0 0 0 1 0 0 1 0 0 0]
      |         |     |      ]
0 1 0 2+0 0 0 0+5 0 0 1 0 0 0]
  |   |         |     |      ]
0 1-1-1 0 0 0 0 1-4-1-1 0 0 0]
                             ]
0 0 0 0 0 0 0 0 0 0 0 0 0 0 0]
