0 0 0 0 0 0 0 0 1-1-9-1-1 0 0]
                |       |    ]
0 0 0 0 0 0 0 0 1-1-5-1-1 0 0]
                    *        ]
0 0 1-1-1-1-1-1 0 0 0 0 0 0 0]
    |     |   |              ]
0 0 1 0 0 4 0 2+0 0 8 0 0 0 0]
    |     |   |              ]
0 0 1 0 0 1 0 1 0 0 0 0 0 0 0]
    |         |     *        ]
0 0 1-5-1 7 1-1 1-1-5-1-1 0 0]
      *         |       |    ]
0 0 0 0 0 0 0 0 1 0 0 0 1 0 0]
                             ]
0 0 0 0 0 0 0 0 7 1-9-1 7 0 0]
                             ]
0 0 0 0 0 0 0 0 1-1-4-1-1 0 0]
      *                      ]
0 1-1-2-1-1-1-1-1-1-1-1 0 0 0]
  |                   |      ]
0 1 0 0 0 0 0 0 0 0 1-1-1 0 0]
  |                 |   |    ]
0 1 0 0 0 0 0 0 0 0 4 0 9 0 0]
  |                 |   |    ]
0 1 0 0 0 0 0 0 0 0 1 7 1 0 0]
  |                          ]
0 1-1-1-1-1-6 3-1-1-1-1 0 0 0]
                             ]
0 0 0 0 0 0 0 0 0 0 0 0 0 0 0]