0 0 0 0 0 0 0 0 0 0 0 0 0 0 0]
  *     *   | *   | |   *    ]
0 2 0-5 2-0 5 2 0-5 2-0 5-0 0]
      *     * |   * *   |    ]
0 0 0 0 0 0 0 0 0 0 0 0 0 0 0]
                             ]
0 0 7 0 0 0 0 0 0 7 0 0 7 0 0]
                             ]
7+2 5+0 7+2 7 0 7 5+7 0+2 7 0]
                             ]
0 7 7 0 0 0 0 0 0 0 0 0 7 0 0]
                             ]
0 0 0 0 0 7 0 0 7 0 0 0 0 0 0]
  *                          ]
7 5 7 0 7 2+0 7+5 7 0 0 0 0 0]
                             ]
0 7 0 0 0 7 0 0 7 0 0 0 0 0 0]
                             ]
0 0 0 0 0 0 0 0 0 0 0 0 0 0 0]
      |                      ]
0 0 0 9 0 0 0 0 0 0 0 0 0 0 0]
      |                      ]
0 9 1-9-0 0 0 0 0 0 0 0 0 0 0]
      |                      ]
0 0 0 0 0 0 0 0 0 0 0 0 0 0 0]
                             ]
0 0 0 0 0 0 0 0 0 0 0 0 0 0 0]
                             ]
0 0 0 0 0 0 0 0 0 0 0 0 0 0 0]